que: porque, aquilo, pois
para: ​para, possibilite, possibilitem
com: usando, utilizando, Com
uma: Uma, essa, numa
não: dürfen, nem, porque
por: peloo, pelo, pelos
mais: bastante, muito, menos
como: -como, --como, também
dos: destes, desses, Destes
das: destas, dessas, nas
foi: Foi, será, era
ser: sendo, sê-lo, ter
sua: própria, a, Sua
seu: o, Seu, próprio
mas: porque, pois, Mas
pelo: peloo, por, -pelo
são: ​​foram, eram, sejam
também: -também, também-, etambém
muito: bastante, muitíssimo, muitooos
pela: pela(o, pelaa, pelo
tem: Tem, têm, terá
nos: nestes, Nos, nesses
você: -você, você-, Você
sobre: acerca, sobreo, ​​sobre
está: estará, Está, estára
até: Até, chegando, desde
pode: poderá, deve, poderá-se
ele: ela, Ele, alguém
anos: anos-, anos(, anosA
entre: ​​entre, -entre, entres
mesmo: omesmo, -mesmo, mesmo-
dia: domingo, sábado, mês
ainda: -ainda, também|ainda|ainda, felizmente
bem: muito, lindamente, muitíssimo
isso: isto, aquilo, issoo
quando: "Quando, “Quando, Quando
seus: eseus, os, nossos
sem: Sem, nenhumas, desprovido
todos: todosos, todos-, muitos
nas: Nas, Serj, nessas
ter: tê-lo, tenha, deter
aos: os, dos, seus
fazer: fazer-, fazer-lo, fazerobem
este: esse, ​Este, ​​neste
tempo: tempo/, tempo-, tempoo
pessoas: essoas, pessoas/, pessoas-
vida: vida, vida-, vidaa
onde: aonde, daonde, -onde
ano: mês, Märklin, semestre
forma: maneira, maneirada, maneiração
